2 11 31
###############################
#p     ** *   1 *2 *  * * *   #
# # # #*# # #*#*# # # #*#*#*# #
#  x*     ***  *  1   * 2 * * #
# # # # # #*# # #*#*# # # # #*#
#f     x   x **  *  *   1     #
# # # # # # # # # #*# #*# # # #
#*  *      *  *  *   *    2   #
# # # # #*# # # #*#*# # # # # #
#*    **  *  1     *          #
###############################
